el paso - step
el pasito - small step
el peso - weight
la pesa - weight (gym)
Ella va para Tijuana. - She's going to Tijuana.
camino con mi perro - walk the dog
la mezcla - mix (dog for example)
correr - to run
escoger - to pick (a book)
compartir - to share
mezclar - to mix
la conjugaci\on - conjugation
saltar - to jump
bajar - to get down/off (bus)
probar - to try (taste)
la naturaleza - nature
El es del estado... - He is from the state of...
Carolina del norte - North Carolina
Kenia - Kenya
comenzar - to start, commence
\?De qu\e se trata el audio? - What's the audio about?
presentaciones - introducing people to each other (NOT introducciones!)
administrador de empresas - business admin
viajar - to travel
el consulado - consulate
la embajada - embassy
\?Cual es la diferencia? - What's the difference?
el hijo \unico - only child
acerca de - about
los asuntos - issues
el funcionario consular - consular worker (functionary)
el estadounidense - American
Yo trabajo como... - I work as...
valiente - brave
la lluvia - rain
seco - dry
la nieve - snow
la pantalla - screen
al igual que - just like, as well as
aunque - although
despu\es de (hacer) - after (doing)
pasear - to go for walk (hangout whereas caminar is more walk)
tratar de (always de) - to try
por tres a\nos - for three years
el aceite - oil
el clima - climate
El clima es caliente. (not calor) - The climate is hot.
griego - greek
explorar - to explore
la ciudadan\ia - citizenship
terminar - to end
la lata - can (of soup)
ambos - both
caro - expensive
barato - cheap
Yo almorc\e... - I had for lunch...
almorzar - to have lunch
el almuerzo - lunch
verduras - vegetables
la sopa - soup
la sopa de calabaza - squash soup
el agregado - attache
el ej\ercito - army
la suegra - mother in law
el cu\nado - brother in law
crecer - to grow up
nacer - to be born
mudarse - to move (house)
limpiar - to clean
cenar - to have dinner
descansar - to rest
durar - to last (class)
obtener - to get, to receive
el tiempo libre - free time
Les presento a... - Let me introduce you to...
por eso - that's why
por el contrario - on the contrary
por lo general - generally
el segmento - segment (of audio)
com\unmente - commonly
relajarse - to relax
sobre todo cuando - especially when
el ejercicio - exercise
estar de acuerdo - to agree
que clase de peliculas - what type of movies
la navidad - Christmas
la canci\on - song
el hielo - ice
el h\ibrido - hybrid (bike)
cuentame - tell me
cualquier - any, whatever, whichever
templado - mild (weather)
el invierno - winter
el sendero - trail
correr por los senderos - to run on the trails
A m\i me gustan las personas as\i. - I like people like that.
amplio - wide (experience)
productivo - productive
el cargo - position (work)
f\acil - easy
lograr - to achieve
duro - hard
el objetivo - objective
la misi\on diplom\atica - diplomatic mission
el gobierno - government
en todo el mundo - around the world
promover - to promote
la pol\itica exterior - foreign policy
la responsabilidad - responsibility
variado - varied
proteger - to protect
el ciudadano - citizen
el inter\es - interest
en el extranjero - abroad
la experiencia - experience
el diplom\atico - diplomat
propio - own
el consejo - advice
la queja - complaint
trabajador - hardworking
lejos - far
el d\ia anterior - the day before
un placer - a pleasure (to meet you)
servir (para) - to be used (for)
Las llaves sirven para abrir la puerta. - The keys are for opening the door.
la cartera - wallet
guardar - to keep (money in wallet)
los tijeras - scissors
el reloj - clock, watch
el teclado - keyboard (for computer)
el parlante - speaker (computer)
el l\apiz - pencil
la impresora - printer
el abrelatas - can opener
el agente de seguridad - security agent
en cuenta - in mind
a pesar de esto - despite this
sin duda - without a doubt
por supuesto - of course
en resumen - in summary
estar ubicado - to be located
la cantidad de habitantes - number of inhabitants
la mayor\ia de mi vida - most of my life
la pintura - painting
la f\abrica - factory
dar un paseo - to go for a walk
uno al otro - each other
silvestre - wild
en lugar de - instead of
soler - used to, to be wont to do
girar - spin
hace 20 a\nos - 20 years ago
extra\no - weird, strange
la capital - capital (of country)
el oso - bear (animal)
plano - flat
la cebolla - onion
cercano - near
manegar - to drive
recordar - to remember
al lado de - next to
en cada uno - in each one
la tradici\on - tradition
\esa - that one
los mariscos - seafood
la calle - street
el turista - tourist
los feriados - holidays
ninguno - none
No hay ninguno. - There are none.
acampar - to camp
el condado - county
el fantasma - ghost
el musulm\an - muslim (man)
el granjero - farmer
el repollo - cabbage
afueras - outskirts/suburbs
la torre - tower
la sede - branch, headquarters
la respuesta - answer
el cr\aneo - skull
la estatua - statue
la electr\onica - electronics
la placa de circuito - circuit board
despacio - slow
\?Qu\e quiere decir _ en espa\nol? - What does _ mean in Spanish?
disculpe - pardon me
de vez en cuando - from time to time
No...sino que - I do not...but rather
de esa manera - that way
contar - to tell (about)
reci\en - recently
apenas - barely
\?De qu\e parte? - From what part (of country)?
mandar - to send
enviar - to send
encantar - to enchant (a city)
el puesto - post (diplomatic)
\!No me diga! - You don't say!
lleno - full
empacar - to pack
llegar - to arrive
el aeropuerto - airport
temprano - early
el destino - destination
el precio - price
razonable - reasonable (price, person)
disfrutar de - to enjoy
\?Que precio tiene la agua? - How much does the water cost?
tomar - to drink, to take (a train)
como - as (I'm going to...)
recoger a - to pick up (from school)
la cena - dinner
el plan - plan (for vacation)
el plano - plan (architectural but not for weekend!)
la caja - box
la maleta - suitcase
la cervecer\ia - brewery
al aire libre - outdoors
tocar m\usica - to play music
estar seguro de que - to be sure that
durante - during
el alimento - food
a cambio de - in exchange for
la deuda - debt
el apoyo - support
apoyar - to support
abastecer - to supply, provide
el alcance - scope, extent
profundizar - deepen
agregar - to add (to what was said)
la fuente - source, origin
la cumbre - summit (pol)
tras - after, behind
atravesar - to cross, cut across
el monto - amount, quantity
adem\as de - besides, also, additionally
aparte (de) - apart from, besides
asimismo - in addition, also, likewise
ni, tampoco - neither (nor)
encima - on top of, on top of that (disaster)
es m\as - what's more
sumado a - along with
de hecho - in fact
por a\nadidura - in addition to, into the bargain
por un lado/por otro lado - on one hand/on the other
por si fuera poco - and if that was not enough
sobre todo - above all
adelante - forward, ahead
el senador - senator
comparecer - to appear (before Congress)
el plazo - term, time limit
la entrevista - interview
el solicitante - applicant (visa)
sin embargo - nevertheless, however
luchar (contra) - to struggle, to fight (against)
a menudo - often
aprobar - to approve, pass (a law), pass (a class)
a trav\es de - across, through
negarse - to decline
acabar - to finish, terminate
la palize - beating
juzgar - to judge
el orgullo - pride
orgulloso - proud
ense\nar - to teach, show
t\u/tu - you/your
entrevistar a - to interview
la compra - purchase
en este momento - at this time
ya que - since
yo por mi parte - as for me
dentro de - within, inside
por esta raz\on - for this reason
hay que - must
la meta - goal
mejorar - to improve
el cajero - cashier
el idioma - language
dedicado - dedicated
nadar - to swim
estudioso - studious
la destreza - skill
llenar - to fill out
la comprensi\on - comprehension
antiguo - former (boss)
el embajador - ambassador
el l\ider - leader
el negociador - negotiator
el jefe adjunto de la mis\ion - DCM
el servicio exterior - the Foreign Service
llevar a cabo - to carry out
el personal - personnel
la coordinaci\on - coordination
coordinar - to coordinate
respetar - to respect
romper - to break
las gafas - glasses
tirar - to throw away
el agujero - hole (in ground)
la bolsa - bag, raft
atar - to tie, attach
la cuerda - rope
detener - to stop
parar(se) - to stop, (stop, stand up)
la roca - rock
la oreja - ear
detr\as - behind
sonre\ir - to smile
la sonrisa - smile
el vendaje - bandage
odiar - to hate
el sobrino - nephew
la sobrina - niece
asistir a - attend (class)
el correo electr\onico - email
culto - cultured, educated
el rango - rank (professional)
genial - brilliant, masterly
el presupuesto - budget
recursos humanos - human resources
encargado - in charge
la regla - rule, ruler (classroom)
el tenis - sneakers, tennis
el mesero - waiter
cumplir - to fulfill, satisfy, accomplish
agradable - pleasant, agreeable
la hoja - page, sheet, leaf
el t\itulo - title (of book)
parecido - similar
alg\un - some
cerca de - close to
el apartamento - apartment
algo - something
el titular - headline
la facilidad - ease
la manera - way (of studying)
la ca\ida - fall (to the ground)
por suerte - luckily
escribir correos electr\onicos para - to write emails to
el hueso - bone
el hierro - iron
el helecho - fern
el techo - ceiling
la rueda - wheel
empujar - to push
destrozar - to break, shatter, tear apart
la br\ujula - compass
la vecindad - neighborhood
ofrecer - to offer
inmobiliario - real estate (adj)
bajo la direcci\on de - under the direction of
vivir en el campo - to live in the country
acercar - to approach
equivocado - wrong, mistaken
a\un - even, yet, still
asustar - to scare, frighten, startle
la ola - wave (of water)
huir - to run away, escape
meter - to put, insert, place
hay un (never el/los) - there is
la granja - farm
alrededor - around, round
de repente - suddenly
el ancho - width
jam\as - never
emocionado - excited
topar - to come across, run into
la p\olvora - gunpowder
averiguar - to find out, look up
esconder - to hide
remar - to row
alejarse - to walk away, recede
caer - to fall down
ensordecer - to deafen
agarrar - to grab, catch, hold
al cabo - after
hundir - to sink (ship)
calentar - to heat, warm
desesperado - desparate
la costumbre - habit, custom
la piedra - stone
tal(es) - such
la tonter\ia - foolishness, nonsense
(para) chuparse los dedos - to lick fingers (delicious)
la empresa - company
el taladro - drill
el cuello - neck
rollizo - plump
el bigote - mustache
la valla - fence
la cerca - fence
soportar - to bear, endure
opuesto - opposite
despertar - to wake
la corbata - tie (clothing)
soso - bland, flavorless
la lechuza - owl
pardo - brown
volar - to fly
el berrinche - tantrum
la d\ecada - decade
el prop\osito - purpose
estar a 10 minutos de - to be 10 minutes from
centrarse - to focus
cual es (not estar) - What/which thing
la esquina - corner
la parada - stop (bus)
t\u mismo - yourself
como mencion\e antes - as I mentioned before
en fin - in short
occidente - west
desarrollado - developed
la asignaci\on - assignment
la capacitaci\on - training (languages)
para tener \exito - in order to be successful
enfocarse - to focus on
feliz (de ir) - happy (to go)
a pie - by foot
trabajar desde su casa - to work from (his) home
el valor - value (of a nation)
fomentar - to foster
la poblaci\on - population
tenso - tense (emotion)
nervioso - nervous
monitorar - to monitor
prevenir - to prevent
estar a cargo de - to be in charge of
la propiedad - property (physical)
implicar - to imply
satisfecho - satisfied
ONU - UN
expuesto - exposed (to emotions)
contener - to contain
en voz alta - out loud (read)
debajo - under, underneath
delante - in front
el anuncio - advertisement
el peregrino - pilgrim, migrant
la loma - knoll, bank
cruzar - to cross
el pecho - chest
erguido - straight, erect
mentado - mentioned
mencionar - to mention
a\un menos - even less
madrugar - to get up early
acarrear - to carry
la vela - candle
desde entonces - since then
la masa, la misa - mass (church)
la fogata - (camp)fire
el esti\ercol - fire
la mazorca de ma\iz - corncob
pertenecer - to pertain, belong
el ferrocarril - railroad
ensartar - to link, string together
el bote - boat, pot
el ruido - noise
chocar - to hit, collide, crash
el legado - legacy
en cuanto - as soon as, as far as
poseer - to possess, own
salpicar - to sprinkle, splash
el olor - scent, oder
debido a - due to
la ganadera - livestock
la ganader\ia - raising livestock
la receta - recipe
diariamente - daily
la res - beef (animal itself)
la rodaja - slice (food)
cotidianamente - daily, quotidian
el \ambito - scope, environment
libertad de culto - freedom of religion
la belleza - beauty
reposar - to rest
el muro - wall
adoquinado - paved
atesorar - to treasure
la caza - hunting
el almirante - admiral
el siglo - century
el dominio - domain, dominion, rule
sufrir - to suffer
aprovechar (para) - to take advantage (of)
sacudir - to shake, jolt, sway (train)
la pierna - leg
silbar - to whistle, hiss
el freno - brake
fijar - to fix, settle, focus, set
fijarse - to set, become fixed, take notice
dirigirse - to address oneself to someone
la locura - craziness
tener sed - to be thirsty
tener cuidado - to be careful
tener raz\on - to be correct
tener sue\no - to be sleepy
tener ganas (de) - to feel like
tener fr\io - to be cold
tener calor - to be hot
tener prisa - to be in a hurry
el significado - meaning
por todo eso - for all these reasons
cada instante - every moment
no solo...sino tambi\en - not only...but also
el v\inculo - relationship (bilateral)
otorgar visas - to grant visas
en cuanto a - regarding
gestionar relaciones - to manage relations (intl)
intentar - to intend, try
reforzar - to reinforce (intl relationship)
el pa\is anfitri\on - host country
el sal\on de clases - classroom
relacionado - related
en mi caso - in my case
representar (a EEUU ante el mundo) - to represent (the US to the world)
Latinoam\erica - Latin America
elegir - to choose, pick
aveces - sometimes (only present!)
pelear - to quarrel
el caucho - rubber
el programa - program (computer)
raramente - rarely, seldom
la esclavitud - slavery
f\acil de leer - easy to read
raro - rare
arrimar - to pull up, bring close
el hoyo - hole
cavar - to dig
la carretera - road, highway
la culebra - snake
pizcar - to pinch, pick (strawberries)
la fresa - strawberry
morder - to bite
acostarse - to lie down, go to bed
echar - to cast, throw, put
la carpa - tent, carp (fish)
el hombro - shoulder
la mirada - look (appearance), gaze
prestar - to lend
en t\erminos diplom\aticos - in diplomatic terms
tener el compromiso de - to have the obligation of
los medios - the media
un parte clave - a key part
reconocer - to recognize
conforme - agreeable, according
la rodilla - knee
estacionar - to park
el toldo - hood (of car), tent
sollozar - to sob
quiz\as - perhaps, possibly
partir - depart, split, start out
salvaje - wild
la maldici\on - curse
el due\no - owner
la pandilla - gang, band
casarse con - to get married to
alejado - far away
enfadado - angry, pissed off
cabalgar - to ride
ladrar - to bark (dog)
el p\aramo - moor
el suelo - soil, ground
el tama\no - size
el delito - crime
suceder - to happen, occur
se\nalar - to point, mark
mientras (que) - while
dar cuenta - to account for, give an account
desde luego - of course
la libra - pound (UK)
despedir - to dismiss, say goodbye, sack
la colina - hill
el sonido - sound
llorar - to cry, mourn
la ci\enaga - swamp
aquel(los), aquella(s) - that
oscuro - dark
rubio - blond, fair
delgado - slim
la mitad - half, middle
hacia - to, towards
la se\nal - mark, signal
capaz (de) - capable (of)
enterarse - to find out
arriba - up, over, above
atrapar - to trap, catch
comprobar - to check, make sure
famoso por - famous for
tan grande como - as big as
seg\un - according to
pens\andolo bien - on second thought
afortunadamente - fortunately
Me imagino que... - I imagine that...
Y a prop\osito... - and by the way...
precioso - beautiful
la arena - sand
la inmersi\on - immersion (language)
repleto de vida - full of life
magn\ifico - magnificent
los eventos actuales - current events
el tratado - treaty
combatir - to combat
el fraude - fraud
en estos campos - in these fields
sordo - deaf
restringido - restricted (zone)
contrator (chofer) - to hire (chauffeur)
el empleado local - LES
el refugiado - refugee
la sanci\on - sanction
emocionar de - to excite (about living there)
el p\ajaro - bird
el campesino - peasant, farmer
entregar - to deliver, submit
el soldado - soldier
el Reino Unido - United Kingdom
la u\na - nail (finger)
hacer algo con las u\nas - to do something with no resources (ie teach)
el pegamento - glue
el pincel - brush (paint)
el borrador - eraser
la escalera - stairs
fuera - outside, away
el deber - duty
el abrigo - coat
roto - broken (neck)
la cima - top, peak
el pa\nuelo - handkerchief, scarf
pillar - to catch (criminal)
el tendero - shopkeeper
el cartero - postman
la le\na - firewood
la espalda - back (body)
el rostro - face (body)
blando - soft, tender, smooth
yacer - to lie, to sit
al rato - after a while
el alivio - relief (feeling)
quemar - to burn (a piece of paper)
ocultar - to hide (something)
colgar - to hang, hang up
adecuado - suitable, appropriate
el comedor - dining room
fallar - to fail
la cadena - chain
la niebla - fog
el bulto - shape, mass
herido - injured
estrecho - narrow
el fango - mud
arreglar - to fix (a lamp)
j\ardin infantil - kindergarten
adivinar - to guess
embarazado - pregnant
atento - atentive
atender - to attend to (person not event)
el cari\no - love/care (for child), my dear
el parto - birth of child
soltero - single (marital status)
la poes\ia - poetry
tramitar - to process (visas)
por lo tanto - therefore
el lazo - tie (bilateral)
el esfuerzo - effort (to improve intl rels)
valioso - valuable
llevar a la ni\na a la escuela - to take the girl to school
la ventanilla - window
la solicitud - application (for visa)
el hom\ologo - counterpart (in other govt)
tener en cuenta - to take into account
el tema - topic, theme (not subjeto or topico!)
el acento - accent
Hace seis a\nos que yo trabajo. - I have been working for six years now.
analizar - to analyze
apreciar - to appreciate
una ni\na de cinco a\nos - a five year old child
estar desacuerdo - to not be in agreement
todav\ia - still, yet
postizo - fake (beard)
a principios - early
exigir - to demand, require
difundir - to spread (message)
la enmienda - amendment
firmar - to sign (document)
ampliar - to enlarge
el var\on - male
conseguir - to get, achieve, win
estatal - state (adj)
el juez - judge
pueblo peque\no, infierno grande - small town, big hell
sovi\etico - soviet
estar interesado en - to be interested in
tener curiosidad - to be curious
la colonia - neighborhood
tomar la decisi\on - to make a decision
me interesa saber - I'm interested to know
\ultimamente - lately
hacer caminata - to go for a walk
el t\e - tea
el barco - ship
florecer - to flourish
el amante (de cerveza) - lover (of beer)
verdaderamente - truly
cuyo - whose
el trigo - wheat
la tela - cloth, fabric
el seguro - insurance
sostener - to sustain
por todo lado - everywhere
la joya - jewel, jewelry
la plata - silver
la mina - mine (silver)
el emprendedor - entrepreneur
hundar - to establish
impulsar - to trigger, encourage
vale la pena (hacer) - it's worth it (to do it)
la huelga de hambre - hunger strike
pender - to pend, hang
tener lugar - to take place
admirar - to admire
el valle - valley
trasladarse - to move, relocate, get around
la carreta - cart
costoso - expensive
reemplazar - to replace
la inversi\on - investment
colocar - to put, place
el empresario - businessman, entrepreneur
el gasto - expense
la obra - work, construction site
el terreno - ground
recaudar - to recover, collect (usually money)
llano - flat (ground)
el tramo - stretch, length
el puente - bridge
enfrentar - to deal, cope, face
el obrero - worker
aplastar - to crush, smash
tender - to tend, extend, lay (track)
Efay-Esay-E - pronunciation of FSI
probablamente - probably
la catarata - waterfall
seguramente - surely
u - or (before o or ho sounds)
e - and (before i or hi sounds)
la marcha - protest
me demor\e dos horas en llegar - it took me two hours to get there
el imprevisto - unforeseen event
lento - slow
la manifestaci\on - protest
las obras - construction
en coche - by car
el cemeterio - cemetery
la demora - delay
el sindicato - union (of teachers)
por - through (the streets)
a partir de (los ocho) - starting at (8:00)
afectar - to affect
la ventaja - advantage
la desventaja - disadvantage
el costo - cost
costar - to cost
el garaje - garage
El D\ia de Accion de Gracias - Thanksgiving
el pavo - turkey
la cuenta - account
el terremoto - earthquake
el brote - outbreak (of COVID)
da\nar - to damage
e\olica - wind (adj)
la autopista - highway
la beca - scholarship
la red - network
ONG - NGO
el lucro - profit
complejo - complex
difunto - deceased
la ofrenda - offering (religious)	
el retrato - portrait
el recuerdo - memory
el esqueleto - skeleton
la jornada - working day
la rama - branch of govt
el empate - tie, draw
instilar - to instill (a feeling)
instar - to urge
en conjunto - together with, on the whole
\!Qu\e padre! - Cool!
apasionante - exciting (to be a teacher)
por desgracia - unfortunately
graduarse - to graduate
por mi cuenta - on my own
grabar - to record
asignar - to assign
la estad\ia - stay
conversar - to converse
el analista - analyst
los chismes - gossip
subir arboles - to climb trees
la maestr\ia - masters degree
el doctorado - PhD
el salario - salary
c\alido - warm
prometedor - promising
ansiar - to yearn, desire
alcanzar - to reach, achieve
el mellizo - twin
agradecido - grateful
defraudar - to let down, defraud
la ansiedad - anxiety
la cobija - blanket
descuida - don't worry
revisar - to look out, check out
brincar - to hop, bounce
agridulce - bittersweet
el hogar - home, hearth, fireplace
embargar - to seize
inquietante - disturbing
la piel - skin
aguardar - to wait, expect
voltear - to flip, tumble
hallar - to find, discover
entretener - to entertain, detain, distract
arriesgar - to risk
el asombro - astonishment
enloquecer - to drive crazy
la verg\\uenza - shame
dem\as (amigos) - rest (of friends)
la velada - evening, soiree
perseguir - to pursue (a dream)
cautivar - to captivate
repentino - sudden
entristecer - to sadden, to grieve
desechar - to discard, reject
lidiar - to deal with
sospechar - to suspect
cien por cien - 100%
el apag\on - failure, brownout
disponible - available
apagar - to turn off (the lights)
interesar - to interest (someone)
obligar - to force (action)
planter - to raise (issues)
alistarse - to enlist (in the army)
mediante - through
el usuario - user (of website)
entablar - to establish
el encuentro - meeting
no pienso perderme la fiesta - I don't plan on missing the party
la licenciatura - Bachelor's degree
el pasante - intern
la remesa - remittance
ingresar a - to enter (university)
la carrera - college degree
la calificaci\on - grade (college)
el pr\estamo - loan (college)
el deportista - athlete
el fondo - funds (for college), back (of bus)
estar por hacer - about to do
la preparatoria - high school
el pasaje - fare (bus)
incapaz - unable
la matr\icula - tuition
el hospedaje - lodging
el procedimiento - procedure
mientras tanto - in the meantime
el portero - porter, janitor, caretaker
encender - to turn on, ignite
el par - pair
sobresalir - to protrude, excel
desenvolver - to unfold, develop
amanecer - to dawn
deshacerse - to get rid of, fall apart
la risa - laugh
el quehacer - chore, task, todo
recorrer - to travel, walk
el pasillo - hall, aisle
no obstante - however, nevertheless
recobrar - to recover
borrar - to erase
acaso - perhaps
el acosador - stalker
tropezar - to trip over, run into
escaso - scarce, little
independientemente - independently (decided)
hereditario - hereditary
hablar a - to call (may not answer)
amenizar - to liven up (the party)
la comida - food, dinner
Te espero a ti y tu esposa - I hope to see you and your wife.
festejar - to celebrate
el desfile - parade
el escudo - coat of arms
el h\eroe - hero
reunirse - to get together
el cura - priest
entonces - then (adj)
encabezar - to lead (pol movement)
el reconocimiento - recognition
consistir en - to consist of
los fuegos artificiales - fireworks
la ra\iz - root, origin
tocar tierra - to touch down (hurricane)
as\i que - so
emitir - to broadcast
pronosticar - to forecast
enfrentarse - to face (difficulties)
el desastre - disaster
la inundaci\on - flood
desprotegido - unprotected
aumentar - to increase (concern)
permanecer - to remain
tener a la mano - to keep on hand
el lodo - mud
para - in order to, recipient, destination, deadline
el jugo - juice
tornar - to transform, turn
premiado - prized
la l\agrima - tear (eye)
el collar - necklace
estar molesto con - to be mad at
navegar - to sail
el asado - barbeque
pasar - to pass (through city)
el partido - match (football)
el aficionado - fan (football)
la entrada - ticket (football)
el equipo - team
el campe\on - champion
empatar - to tie (a game)
la temporada - season (sports)
las ventas - sales (of t-shirts)
(en) promedio - (on) average
la encuesta - survey
la oveja - sheep
sucio - dirty
el muelle - dock
la ballena - whale
destacar - to highlight (a fact), stand out
merecer - to deserve, earn
la mejilla - cheek
empapar - to soak
la charla - chat
disimuladamente - covertly
la boda - wedding
esfumarse - to vanish, fade
la alma - soul
quitar - to take off (clothes)
vacio - empty
hecho en casa - homemade
el recuento - record (number of deaths)
atraer - to attract
revelar - to reveal
el problema ha aumentado - the problem is worse (not es peor)
por lo que veo - from what I see
el enfermo - nurse
la apuesta - bet
el lapso - lapse, span
consigo - with him
el af\an - eagerness, hard work
el enemigo - enemy
reclutar - to recruit
suministrar - to supply, furnish
p\esimo - lousy, appalling (conditions)
la realeza - royalty
apoderarse - to seize
rastrear - to track, trace
desprenderse - to come off, to break away
congelar - to freeze
el cometido - task, duty
acaecer - to happen
rendirse - to surrender
el trastorno - disorder (medical)
redondo - round
amargo - bitter (feeling)
perezoso - lazy
en cambio - however
la formaci\on - training
tutear - to address as tu
perfeccionar - to improve
el despacho de abogados - law firm
el medio ambiente - environment
la aclaraci\on - clarification
so\nar (con) - to dream (of studying)
maduro - mature
contar con - to have (money)
constar de - to consist of
el acceso - access
seguidamente - next
desear - to desire
realizer - to carry out
la herramienta - tool
el alumno - student
sustituir - to substitute
enriquecer - to enrich
incentivar - to encourage
convertirse en - to become
el requisito - requirement
el vuelo - flight
la escala - layover
cancelar - to cancel
prometer - to promise
pasar bien - to have a good time
el torneo - tournament
la medida - measure (of security)
consumir - to consume
el ingreso - income
gastar - to spend
el alquiler - rent
el acontecimiento - event
prestar atenci\on - to pay attention
la marca - brand
patrocinar - to sponsor
ir de la mano - to go hand in hand
en s\i - per se
el para\iso - paradise
aportar - to contribute
el marinero - sailor
el plantador - farmer
la escoba - broom
reclutar - to recruit
brindar - to offer, present
el matiz - nuance, shade
emprender - to undertake, launch
el rasgo - feature, trait
deponer - to lay down (arms), depose
el aprendizaje - learning
darse cuenta de - to realize
estar acostumbrado a - to be used to
tener el control - to be in control
la actitud - attitude
volver a (hacer) - (to do) again
cometer errores - to make mistakes
repasar - to review (vocab)
el rendimiento - performance
faltar - to miss (work)
contrarrestar - to counteract
el bienestar - well-being
adquirir - to acquire
inclinarse por - to be inclined to (prefer books)
en parte - partly
puesto que - since
el cargador - charger
el almacenamiento - the storage
un dispositivo - device
evitar - to avoid
cargar - to carry
ciertos - some
el conocimiento - knowledge
la memoria a largo plazo - long-term memory
por regla general - as a general rule
atrasado - late, overdue
mostrar - to show, indicate
rechazar - to refuse, reject
sin importar - no matter, regardless of
oler (yo huelo) - to sniff, to smell
el granizo - hail
inc\omodo - uncomfortable, awkward
gui\nar un ojo - to wink (at someone)
manar - to flow, abound
ahondar - to delve, deepen
la huella - mark, footprint
imborrable - indelible
semejante - similar, such
el arrojo - daring, spunk
el pr\ojimo - neighbor
destacado - outstanding, prominent
el mito - myth
la estela - trail, wake
rodear - to surround
atreverse - to dare
la ceniza - ash
el mendigo - beggar
la creencia - belief
funesto - fatal
el predicador - preacher
el rumbo - course, route
analfabeto - illiterate
el tes\on - tenacity
el reto - challenge
el feligr\es - parishioner
desahogarse - to blow off steam
despectivamente - contemptuously
costear(se) - to pay for, afford
la fila - row, line (to stand in)
optar - to opt
por medio - via
uno - one (may do so if one wishes)
con respecto a - with respect to
cursar - to study
la fuga de cerebros - brain drain
el estrato social - social strata
desperdiciar - to waste (money)
el mochilero - backpacker
O sea, - I mean,
aguantar - to put up with, endure
apremiar - to push, press (to act)
plasmar - to give expression to
la cita a ciegas - blind date
quisquilloso - fussy, cantankerous
hartar de - to be fed up with
la crispaci\on - tension
tardar - to delay, be slow
la predicaci\on - preaching
la vivienda - housing
los ahorros - savings
por la tarde - in the afternoon
la convocatoria - the announcement
surgir - to arise
garantizar - to ensure
el desempe\no - performance
la mejora - improvement
copiar y pegar - to copy and paste
actuar como - to act as
remitir - to refer, remit
entorpecer - to hinder
rondar - to haunt, prowl
agotar - to exhaust, drain
el azar - luck, chance
la amenaza (para) - threat (to)
antemano - beforehand
acudir - to keep, turn up
la voluntad - will
la madurez - maturity
la daga - dagger
el rayo - ray, thunderbolt
acotar - to narrow down, limit
sonar - to sound, ring, play
tajante - cutting, positive
restar - to subtract
sumar - to add, join (plea)
la jactancia - boasting
disponer - to provide, arrange
la ausencia - lack, absence
el cohete - rocket
el m\etodo - method
met\odico - methodical
en lo que respecta a - with regards to
el papel - role (pol)
el castillo - castle
la batalla - battle
la puesta en pr\actica - implementation
unir - to unite
el informe - report
afirmar - to affirm
percibir - to perceive
el lector - reader
el equilibiro - balance
cabe se\nalar - it should be noted
la obra maestra - masterpiece
el palacio - the palace
la profundidad - depth
el reflejo - reflection
el espejo - mirror
llamar la atenci\on - to draw attention
aparecer - to appear
la costurera - seamstress
la farola - streetlight
conminar - to condemn
el s\otano - basement
abrumar - to overwhelm
derrumbarse - to collapse
el atasco - clog, jam
el concejal - councillor, alderman
abarrotar - to crowd, cram, overstock
estallar - to explode
airado - angry, irritated
primero/primer - first
segundo - second
tercero/tercer - third
cuarto - fourth
quinto - fifth
sexto - sixth
s\eptimo - seventh
octavo - eighth
noveno - ninth
d\ecimo - tenth
el lunes - monday
el martes - tuesday
el miercoles - wednesday
el jueves - thursday
el viernes - friday
el sabado - saturday
el domingo - sunday
doscientos - 200
trescientos - 300
cuatrocientos - 400
quinientos - 500
seiscientos - 600
setecientos - 700
ochocientos - 800
novecientos - 900
Es (a eso de) la una. - It's (about) one o'clock.
Son las dos. - It's two o'clock.
Son las tres menos diez. - It's ten till three o'clock.
Cinco para las tres. - Five till three o'clock.
la tribu - tribe
efectivamente - indeed
invidente - blind
pese a - despite
en lo personal - personally
la funci\on - task
en funci\on de - depending on
la prensa - the press
proporcionar - to provide
desempe\nar - to perform
el desaf\io - challenge
afrontar (desaf\ios) - to face (challenges)
lidiar con - to deal with
ser blanco de robos - to be a target for robberies
el compa\nerismo - the companionship
la habilidad - ability
ciego - blind
dibujar - to draw
breve - brief
la cicatriz - scar
la cirug\ia - surgery
la ganancia - gain, profit
la botella - bottle
la elaboraci\on - production (of tequila)
remontar - to go back, ascend
provenir - to come from
pasarla bien - to have a good time
el marco - frame (of bike)
medicina ambulatoria - home health care
las Filipinas - the Philippines
partido pol\itico - political party
el permiso - permission
el postre - dessert
concibir - to conceive, envisage
la carne - meat
desplegado - displayed, unfolded
sobreag\\ue (sobrecargar) - overloaded
el rumbo - course, direction (of your life)
la muleta - crutch
la tala - cutting down (of trees)
la merma - decrease, reduction
mermar - to decrease
aplazar - to postpone
arm\onico - harmonic
desbocar - to lose control
restante - remaining
acertar - to guess
advertir - to warn, notice
el terr\icola - earthling
la penuria - extreme poverty
el envenenamiento - poisoning
resfr\io - cold
padecer - to suffer
medir - to measure
proveer - to provide
convencido - convinced
a favor de - in favor of
comprometido - committed, involved
la denuncia - denouncement
ocuparse - to take care of (intl issues)
el asesor - advisor
el siento - seat
someter (por) - to subject (to)
m\as all\a - beyond
renunciar - to resign, renounce
comprometerse - to commit onself
desplazado - displaced
a cause de - due to
poner fin a - to put an end to
por temor a - for fear of
la desconfianze - distrust
fortalacer - to strengthen
el funerario - mortician
la tanatoest\etica - people who make up the dead
inspiradoro - inspiring
vincular - to link (together)
la brecha - gap (btw edu system and labor market)
el electricista - electrician
al final - in the end (not finally)
dimitir - to resign
la urna (electoral) - ballot box
la reivindicaci\on - assertion, grievance
la coacci\on - coercion
realizar - to perform, carry out
retorcer - to twist, contort
la comisar\ia - police station
el calabozo - prison cell, dungeon
la fianza - bond (jail)
la multa - fine, penalty
asestar - to deal (a blow), land, throw
la pu\nalada - stab
agobiado - burdeoned
al parecer - apparently
atemorizar - to terrorize
caluroso - warm (reception)
la similitud - similarity
el pleito - lawsuit
el juicio - trial
el sondeo - probe
la derrota - defeat
leal - loyal
mantener a raya - to keep in line
el atentado - attempt, assault
sembrar - to sow (discord)
el alcalde - mayor
suavizar - to smooth
el trato - treatment, deal, relationship
desatar - to unleash
convocar - to summon
tapar - to cover, seal
vaticinar - to foretell
para colmo de males - to add insult to injury
d\ebil - weak
el callej\on - alley
el sentido de humor - sense of humor
el venado - deer
pleno - full
sofocar - to put out, suffocate
el barrendero - street-sweeper, scavenger
alojar - to accomodate, house
velar - to ensure, to wait up
la pieza - piece, part
id\oneo - suitable
apuesto - dapper
la sombra - shadow
indigente - bum (better than mendigo)
el buque - ship, vessel
Escocia - Scotland
es decir - that is to say
dise\nar - to design
el alambre - wire
el taco de alambre - taco with long stringy meat like a wire
hondo - deep
la galleta - cookie
estrenar - to launch (TV show)
la vigencia - validity
acoger - to welcome, receive
fracasar - to fail
marcado - marked, pronounced
la aniquilaci\on - annihilation
la cabida - capacity, room
despiadado - ruthless
agredir - to attack
el escondite - hiding place
rehusar - to refuse
la presi\on - pressure
el sudor - sweat
azotar - to spank, whip, flail
secuestro - seizure (of drugs), kidnapping
imprescindible - essential
el dirigente - leader
conducir - to lead, bring, handle
el poblado - village
caber - to fit (on screen)
el catar - tasting (wine, coffee)
devolver - to return (item to store)
la falda - skirt
gotear - to drop, leak
mareado - dizzy
entorno - environment (virtual)
dar a luz - to give birth
el colch\on - mattress
parir - to give birth
estrechar - to narrow, grasp (hands)
el porvenir - future
la sabidur\ia - wisdom
el cobarde - coward
experimentar - to experience
callarse - to keep quiet
amparar - to protect
la vidriera - window
el cintur\on - belt
incitante - inviting
vencer - to overcome, master, defeat
enfatizar - to emphasize
el soborno - bribe
poner en evidencia - to expose
el flujo - flow
golpear - to hit
retrasar - to delay
sin falta - without fail
deletrear - to spell
acceder - to access
a finales de - at the end
oponerse - to oppose
la aprobaci\on - approval
aspirar a - to aspire to
la crianza - upbringing, raising (of children)
justo - fair
a su vez - at the same time
a nivel mundial - world wide
la oferta - offer (of services)
asequible  - affordable
estimular - to stimulate
la feria - fair (trade)
el santuario - sanctuary (wildlife)
desconocido - unknown
el adelanto - advancement
la riqueza - wealth
equitativo - equitable
ya sea - either
a fin de cuentas - at the end of the day
el eje - mainstay (of the economy)
la demostraci\on - proof
invertir - to invest
el recorte - cut (to budget)
fundar - to found
desesperar - to despair
avecinar - to approach, loom
cabal - exact, thorough
el sure\no - southerner
rellenar - to fill, fill out
la nalgada - spanking
lucir - to shine
el alegato - allegation, plea, argument
aclamar - to cheer, aclaim
a\norar - to yearn
re\ir - to laugh
la pradera - meadow
esmerarse - to strive
el sueldo - salary
el catedr\atico - professor
portar - to carry, bear
el regocijo - joy
en que grado - to what degree
la zanahoria - carrot
la lechuga - lettuce
el aguacate -avocado
la col - cabbage
el mojo - garlic and oil sauce
la pasarela
colmar - to fill
la cuadra - block (city)
el bullicio - bustle
deste\nirse - to fade
la piedad - piety
ingenuo - naive
la rabia - rage
callado - quiet, reserved
el cami\on - truck
la finalidad - purpose
el entorno - el environment
el pulm\on - lung
la contaminaci\on - pollution
el encanto - charm
los paisajes - scenery
cuidadoso - careful
el proveedor - provider
el fin - end, goal
el monte - hill
la tregua - truce
la herida - wound
frenar - to stop
punzar - to prick, sting (feeling)
adormecer - to put/go to sleep
el ajetreo - hustle
deslumbrante - dazzling
la clausura - closure
solicitado - in demand
el carruaje - carriage
a medida que - as, according as
el suministro - supply (of smart citizens)
irreflexivo - thoughtless, rash
audaz - audacious
la maniobra - maneuver
la pl\atica - discourse, chat
el egresado - graduate
postularse - to run for office
decepcionado - disappointed
ansioso - anxious
anhelar - to long, yearn
vig\esimo - twentieth
de todos modos - by all means (I must do it)
el pece - fish (alive)
el pescado - fish (dead)
escalar - to climb
el gorilla - gorilla
el ayuno - fast (eating)
la frambuesa - raspberry
a la luz de - in light of
el bono - bond (monetary)
orde\nar - to milk (a cow)
el cenote - cenote
la crisis - crisis
adquisitivo - purchasing power (adj)
mas de - more than + number (not mas que)
la codicia - greed
ser listo - to be smart (not ready)
el saldo - balance (bank)
cometer un error - to make a mistake
el mandato - term (presidential)
la hipoteca - mortgage
el respaldo financiero - financial backing
la bancarrota - bankruptcy
el desempleo - unemployment
el matrimonio - married couple
estar al d\ia con - to be up to date
el dinero en efectivo - cash
la tarjeta de cr\edito - credit card
solucionar - to solve
en el transcurso de - in the course of
el decreciemiento - downturn (economic)
estable - stable
deer - el ciervo
el ba\ul - trunk (luggage)
suspender - to suspend
el arancel - tariff
quebrar - to break, crack, go bankrupt
el pergamino - parchment
el ri\non - kidney
empeorar - to worsen
la barriada - slum
componer - to compose, mend, set
tomar partido - to take sides
alborotarse - to get upset
la viuda - widow
darse vuelta - to turn around
aprisa - quickly
la huerta - orchard, produce garden
el reba\no - flock (of sheep)
la lana - wool
subastar - to auction
la harina - flour
el derrame cerebral - stroke (brain)
abalanzarse - to pounce
la marea - tide
adormecido - asleep (leg)
la gira - tour
vespertino - evening (adj)
ata\ud - coffin
arrojar - to throw (trash)
el desperdicio - trash
la contraventana - shutter
la garganta - throat
a salvo - safe (feeling)
rezar - to pray
el anillo - ring
las crisis - crises
un/otro - never "un otro"
mil milliones - one billion
billion - trillion
la pandemia - pandemic
vacunarse - to get vaccinated
atañer - to concern
poner en cintura - to do what must be done
censurable - objectionable, reprehensible
el capital - capital (money)
el alza - rise (in rates)
la capucha - hood (of jacket)
aproximadamente - approximately
la escopeta - shotgun
la mecedora - rocking chair
acurrucarse - to snuggle, huddle
adinerado - wealthy
la lobina - bass fish
cort\es - courteous
la caricia - pat, stroke
compadecerse - to sympthasize
lanzar - to throw (rocks), launch (career)
a la vez - together, at the same time (strict and nice)
el reproductor - player (DVD)
dar vuelta - to give back
auspiciar  - to sponsor, foster
divulgar - to divulge, publish
brotar - to sprout
la jota - jot, iota
el recorrido - route, path
la p\esame - condolence
el chiche - toy
escasear - to be scarce
aconsejar - to advise
la portada - title page
el ahuyentadora - scarecrow
la sentada - sitting, sit in protest
el follet\in - newspaper serial
la virtud - virtue
entender ni jota - to not understand a thing
dar su sentido p\esame - to offer sincere condolences
manipular a - to manipulate
fluvial - fluvial (adj - river)
patinar - to skate
la acera - sidewalk
inquebrantable - unwavering
agotador - exhausting
el preso - prisoner
el tejado - roof
conmover - to move (emotionally), touch
deseable - desirable
el normalista - student in "normal" where you study to be teacher
el brazalete - bracelet
hecho a mano - handmade
rebajar - to discount
el extranjero - foreigner
estos - these (right here (speaker))
esos - those (over there (by listener))
aquellos - those (far away (third person to speaker/listener))
eso, esto, aquello - only pronoun
esos, estos, aquellos - adjectives/pronoun if already mentioned
ese, este, aquel - adjective/pronoun if already mentioned
la cer\amica - pottery
la ganga - bargain
regatear - to bargain
la tasa de inter\es - interest rate
el inversionista - investor
a punto de - about to
devolver la confianza - to restore confidence
encolerizado - incensed
cabizbajo - crestfallen
el porche - porch
trasero - rear (porch)
siquiera - at least, though
enorgullecerse - to take pride
coser - to sew
la rabia - rage
el recinto - precinct, enclosure, premises
el mozo - waiter, busboy
cuan - how (connector)
es decir - that is to say
fallecido - deceased
la camilla - stretcher (medical)
otros dos - two other (books)
peludo - hairy
el rescate - rescue
el arete - earring
la bisuter\ia - imitation jewelry
el codo - elbow
el antebrazo - forearm
la vereda - sidewalk
azorado - flustered, taken aback
cobrar - to collect, charge (money)
ligero - light, healthy
el trozo - piece (of sushi), slice
deslizar - to slide, slip
la presa - dam, prey, catch
el malhumor - bad mood
gatillar - to trigger
mero - mere
la prenda - garment
la marca - brand, mark
sugerir - to suggest
el contenido - content
el turr\on - nougat
crudo - raw (fish)
el desagüe - drain, gutter
el rascacielo - skyscraper
humilde - humble
la alegr\ia - joy
la valent\ia - courage
digno - dignified
al rev\es - backwards
la patria - homeland
ocasionado por - caused by
a ra\iz de - as a result of
la estabilidad - stability
recaudar fondos - to fundraise
un taller - workshop
sumar esfuerzos - to join forces
solo basta un clic - it only takes a click
descargar archivos - to download files
en cuesti\on de - in a matter of
conllevar - to entail, carry
el fiscal - district attorney
el alcalde - mayor
al parecer - apparently
plantear - to propose, mention
estar dispuesto a - to be willing to
cuplable - guilty
desviar - to divert
vinculado - linked
respaldar - to support
la materia - field (of work), subject (class in uni)
exitoso - successful
ejercer como - to act as (consular officer)
el tratado de libre comercio - free trade treaty
TLCAN - NAFTA
en el marco de - in the context of
involucrar - to involve
el esc\andalo - scandal
la desigualidad - inequality
por su parte - on their end
la incertidumbre - uncertainty
el v\inculo estrecho - close tie
bajo su punto de vista - from your point of view
la mano de obra - workforce
sab\ia vs supe - I knew vs I found out
pod\ia vs pude - I was in a position to vs I was able to and did
quer\ia vs quise - I wanted to vs I tried to
la sastrer\ia - tailor shop
instar - to urge
delantero - front
la salvedad - disclaimer, proviso
avergonzar - to embarrass
atestado - crowded
api\nado - crowded
obedecer - to obey
los empujones - jostle
grosero - rude
a rastra - unwillingly (dragged)
ceder - to cede
esposar - to handcuff
la jefatura - leadership, HQ
el expediente - record, file (court)
tumbar - overthrow (Jim Crow)
el ah\inco - effort
malvado - evil
los honorarios - fee (doctor)
sublevar - to revolt
la propagaci\on - spread (of disease)
a diferencia a - unlike
en la actualidad - currently
factible - practical, feasible
la muerte/la muerta - death/dead woman
contagiar - to spread disease
la sobremesa - post dinner convo, table cover, dessert
cuidar a - to care for
la pancarta - banner, trace
retomar - to return
imprimir - to print
patear - to kick
botar - to throw away, dispose of
la potestad - power (to abolish)
el volante - steering wheel, flier (protest)
el delantal - apron
el hito - milestone
envejecer - to age, get old
contado - counted, told
tachar - to cross out, fault
ganas - desire (to do a thing)
el imperdible - pin, safety pin
la tentativa - attempt (terrorism)
gozar - to enjoy (your life)
condecorar - to decorate (with a medal)
vencido - defeated, beaten
regordete - chubby
el mayordomo - butler
mand\on\mandona - bossy
el trineo - sled
la estampilla - stamp (postage)
el rasguño - scratch, scrape
el chich\on - bump (injury)
el patito feo - ugly duckling
evadir - to escape, evade
coger - to take, catch, get, gather, screw (rude)
amueblado - furnished (with furniture)
honrado - fair, honest, honored
el astillero - shipyard
trepar - to climb
surcar - to plow (boat through waves), ride
martillar - to beat, knock, pound
el tornillo - screw, bolt
la franja - fringe, stripe (of defensive mines)
el matorral - bush, scrub
la llama - flame
h\umedo - damp, wet
el resfriado - cold (sickness)
la correa - strap, leash, belt
la cadera - hip
la bisagra - hinge
el aparato - apparatus, device
el calcet\in - sock
la soga - rope
la polea - pulley
el balneario - spa
fingir - to pretend
la carcajada - laugh
el chapoteo - splash
deprisa - quickly (drive)
la secuela - lasting complication of disease, sequela
el bast\on - walking stick
escurrir - to drip (sweat), wring
enloquecer - to get mad, go wild
patas arriba - upside down
jurar - to swear (in as president)
hacer cola - to wait in line
la cosecha - harvest
el trueno - thunder
el apret\on de mano - handshake
cesto - bin (trash)
el nieto - grandchild
el despacho - office
costar ce\nirse - to be difficult to stick to (schedule)
el sello - stamp (postage)
matutino - morning (adj)
temible - fearsome
arrasar - to raze (bombs), obliterate
la ojera - baggy eyes
rindir informe - to report (info to Congress)
el traje - suit
carmes\i - crimson
desplomarse - to collapse (sick person)
at\onito - amazed (at his death)
rebosar - to overflow
el and\en - platform (train)
amontonarse - to pile up, gather
el sobrecogimiento - awe
agitado - agitated, flurried, seething
el capullo - pod (flower)
la tosferina - whooping cough
el bordado - embroidery
refunfu\nar - to grumble
el sacerdote - priest
el pozo - well (water)
la monja - nun
el ladrillo - brick
el pariente - relative
desbordar - to overflow
el reparo - objection (to proposal), repair
el anciano - elderly
la pizarra - blackboard
la tiza - chalk
el p\arroco - vicar
la rueca - spinning wheel
alentar - to encourage
el hilo - thread
la lana - wool
el gusano - worm, maggot
fregar - to scrub, mop
el hu\erfano - orphan
la aldea - village
estornudar - to sneeze
chulo - cool, pimp
desencadenar - to trigger
la muchedumbre - crowd
lastimar - to hurt
tildado - branded (COVID diplomacy)
el acercamiento - approach (political)
veloz - speedy
insumos - supplies
el aislamiento  - isolation
el auxilio - help
apuntar - to point out
el patr\on - pattern, master, boss
agudizar - sharpen (relationship btw countries)
restringir - to restrict
m\as all\a - beyond
condenar - to convict
elogiar - to praise
el consuelo - comfort
el victimario - victimizer
el fiscal - prosecutor
el yate de lujo - luxury yacht
el turno de noche - night shift
descartar - to discard, dismiss, rule out
ojal\a - hopefully, if only
la banda ancha - broadband
el matiz - nuance
el rodaje - filming, location
arrancar - to tear, pull, extract
certera - accurate, certain
el hallazgo - finding, find (scientific)
abordar - to tackle, approach
Ni siquiera puedo...mucho meno - I can't even...much less
la dimisi\on - resignation (president)
el entierro - burial
el ment\on - chin
el secreto a voces - open secret